shift ( D N B S )	N B S D
append ( Z J O , reverse ( B S M ) )	Z J O M S B
echo ( E U )	E U U
shift ( N O X I )	O X I N
prepend ( L D , G B T )	G B T L D
shift ( F A U )	A U F
echo ( V J S B )	V J S B B
reverse ( V L )	L V
reverse ( copy ( S B ) )	B S
echo ( G F )	G F F
shift ( X E )	E X
reverse ( K U )	U K
reverse ( R H V C )	C V H R
copy ( D H )	D H
shift ( reverse ( B B ) )	B B
reverse ( A M )	M A
append ( I P X O , S K A )	I P X O S K A
copy ( shift ( H Y O ) )	Y O H
copy ( O G B )	O G B
reverse ( Q D O )	O D Q
echo ( O B E )	O B E E
prepend ( Z C , echo ( F S H C ) )	F S H C C Z C
prepend ( C W D , V Z T )	V Z T C W D
reverse ( R K Q G )	G Q K R
echo ( U U T L )	U U T L L
append ( echo ( Y U P E ) , H S K O )	Y U P E E H S K O
echo ( R X J C )	R X J C C
copy ( reverse ( Y M ) )	M Y
prepend ( append ( W Z , A I ) , V W L )	V W L W Z A I
append ( C I Y , shift ( Z G ) )	C I Y G Z
shift ( O R D N )	R D N O
echo ( R L G )	R L G G
prepend ( append ( F Q H , M A N ) , G D P )	G D P F Q H M A N
shift ( copy ( V K E O ) )	K E O V
shift ( copy ( R T I N ) )	T I N R
copy ( V K M )	V K M
append ( L S G U , C U A T )	L S G U C U A T
copy ( A G I L )	A G I L
copy ( reverse ( L T ) )	T L
prepend ( echo ( copy ( echo ( F L ) ) ) , Z F )	Z F F L L L
copy ( X R )	X R
echo ( shift ( G Y T ) )	Y T G G
prepend ( K C K D , E L E T )	E L E T K C K D
copy ( copy ( V K ) )	V K
copy ( C C U )	C C U
copy ( I M C )	I M C
copy ( U M D )	U M D
append ( reverse ( copy ( N Q P H ) ) , B A F )	H P Q N B A F
echo ( copy ( X A J ) )	X A J J
reverse ( I X )	X I
reverse ( Q P H )	H P Q
echo ( G C E R )	G C E R R
echo ( A E )	A E E
prepend ( N R Y S , reverse ( U V G X ) )	X G V U N R Y S
append ( I O , L C S S )	I O L C S S
shift ( reverse ( echo ( W I X Y ) ) )	Y X I W Y
shift ( prepend ( D B T , W B Z ) )	B Z D B T W
reverse ( X K )	K X
copy ( I K )	I K
echo ( R F )	R F F
copy ( U X W V )	U X W V
prepend ( X Y W , N X N X )	N X N X X Y W
echo ( D P Q )	D P Q Q
shift ( copy ( B Y B ) )	Y B B
echo ( P R )	P R R
prepend ( I N B , append ( H F , U V ) )	H F U V I N B
append ( append ( R W S , D T J P ) , S T )	R W S D T J P S T
append ( echo ( M R K ) , B T )	M R K K B T
reverse ( V X M )	M X V
echo ( H V )	H V V
copy ( F G U )	F G U
shift ( L D D )	D D L
append ( U A , reverse ( D N ) )	U A N D
echo ( L Z H F )	L Z H F F
shift ( echo ( V R ) )	R R V
echo ( N S L L )	N S L L L
reverse ( O M Z )	Z M O
append ( M K H W , K Q M U )	M K H W K Q M U
copy ( W J B )	W J B
copy ( T J )	T J
append ( D G S D , P N )	D G S D P N
echo ( T R C T )	T R C T T
reverse ( D Z )	Z D
copy ( S M )	S M
copy ( prepend ( B F A D , Y A ) )	Y A B F A D
echo ( reverse ( reverse ( L U P I ) ) )	L U P I I
copy ( N U I G )	N U I G
shift ( F J P Y )	J P Y F
copy ( prepend ( Y I , O J N L ) )	O J N L Y I
append ( C R E A , append ( D B E , K K G F ) )	C R E A D B E K K G F
copy ( E B V )	E B V
echo ( echo ( J W W ) )	J W W W W
copy ( O O Q )	O O Q
shift ( copy ( shift ( reverse ( Y L A ) ) ) )	Y A L
append ( copy ( H E ) , reverse ( reverse ( B H ) ) )	H E B H
copy ( T K )	T K
copy ( U L L L )	U L L L
echo ( V J R )	V J R R
append ( B V P T , L R )	B V P T L R
append ( E Q , Z C C D )	E Q Z C C D
echo ( J R C M )	J R C M M
append ( C L , shift ( append ( X U H , T S W B ) ) )	C L U H T S W B X
append ( shift ( E A H F ) , echo ( reverse ( T M ) ) )	A H F E M T T
copy ( append ( G M R A , X I W ) )	G M R A X I W
copy ( C W )	C W
shift ( O O )	O O
reverse ( R K )	K R
echo ( prepend ( J B , V G ) )	V G J B B
reverse ( F J B W )	W B J F
reverse ( J N P R )	R P N J
copy ( F P G )	F P G
copy ( P Q )	P Q
append ( shift ( Q G X ) , copy ( E X ) )	G X Q E X
prepend ( K Q , append ( O C B , reverse ( append ( reverse ( B R W ) , F X ) ) ) )	O C B X F B R W K Q
copy ( W R )	W R
copy ( G X )	G X
copy ( copy ( P G ) )	P G
echo ( E H D H )	E H D H H
copy ( echo ( R T ) )	R T T
echo ( T A R R )	T A R R R
shift ( L T P O )	T P O L
shift ( K C F Z )	C F Z K
shift ( C G W )	G W C
append ( Y Y , K Y Z Q )	Y Y K Y Z Q
copy ( O X )	O X
echo ( U N )	U N N
append ( B J S B , G D )	B J S B G D
echo ( shift ( D K ) )	K D D
echo ( F K )	F K K
shift ( O D B H )	D B H O
copy ( H J )	H J
copy ( H Q T O )	H Q T O
shift ( O A )	A O
echo ( P G I K )	P G I K K
shift ( M H W K )	H W K M
shift ( append ( copy ( S O ) , C K ) )	O C K S
copy ( A N F X )	A N F X
shift ( shift ( copy ( Y Z W D ) ) )	W D Y Z
echo ( U U C )	U U C C
shift ( U X R )	X R U
reverse ( T R S )	S R T
append ( Y O , Q B F W )	Y O Q B F W
copy ( copy ( H W R P ) )	H W R P
reverse ( shift ( Z U ) )	Z U
shift ( R U Y D )	U Y D R
echo ( V L B )	V L B B
reverse ( G E T K )	K T E G
reverse ( U Z )	Z U
shift ( F C X )	C X F
prepend ( K B L , X J Q )	X J Q K B L
prepend ( N Z Y E , I C )	I C N Z Y E
shift ( T Y )	Y T
copy ( J H T )	J H T
append ( V W Y , J S S )	V W Y J S S
append ( O X Y , copy ( E H ) )	O X Y E H
shift ( F O Y )	O Y F
shift ( K V N Z )	V N Z K
shift ( G C )	C G
shift ( Q J H Y )	J H Y Q
copy ( echo ( C K H F ) )	C K H F F
append ( O T V , J C )	O T V J C
echo ( I W L )	I W L L
copy ( shift ( L R T W ) )	R T W L
echo ( O X Z )	O X Z Z
echo ( J U U X )	J U U X X
reverse ( W N )	N W
copy ( U W L )	U W L
copy ( O O Z )	O O Z
prepend ( G Y Q Z , M R )	M R G Y Q Z
append ( echo ( I B H ) , H I )	I B H H H I
copy ( U G O N )	U G O N
shift ( W T )	T W
echo ( prepend ( prepend ( P K E , H W A ) , D E F I ) )	D E F I H W A P K E E
reverse ( copy ( U N S ) )	S N U
echo ( prepend ( V J R G , M A D ) )	M A D V J R G G
echo ( N R B )	N R B B
append ( copy ( B H L B ) , T G Q Y )	B H L B T G Q Y
copy ( K G D B )	K G D B
echo ( N B H Z )	N B H Z Z
copy ( copy ( B J ) )	B J
prepend ( E Y , M G O )	M G O E Y
reverse ( R I U )	U I R
shift ( C I Z C )	I Z C C
echo ( S U S )	S U S S
echo ( reverse ( I E ) )	E I I
shift ( U S )	S U
echo ( shift ( append ( H K , G Y G ) ) )	K G Y G H H
reverse ( L M V F )	F V M L
copy ( copy ( M J B ) )	M J B
echo ( R L A C )	R L A C C
append ( copy ( J D D N ) , D P )	J D D N D P
copy ( P F )	P F
reverse ( N A )	A N
shift ( I T G )	T G I
append ( shift ( prepend ( W K O , A B ) ) , O G D E )	B W K O A O G D E
copy ( D Z G )	D Z G
copy ( P T P P )	P T P P
prepend ( O H , copy ( copy ( K B J G ) ) )	K B J G O H
echo ( shift ( shift ( Z O O ) ) )	O Z O O
echo ( R N N I )	R N N I I
copy ( G Z W A )	G Z W A
echo ( G G E L )	G G E L L
copy ( C Y I D )	C Y I D
shift ( J V )	V J
copy ( D R )	D R
copy ( G I Y )	G I Y
shift ( echo ( O G D J ) )	G D J J O
reverse ( S Q )	Q S
echo ( shift ( reverse ( R Y W ) ) )	Y R W W
prepend ( T F H G , K O X )	K O X T F H G
append ( R M N , append ( V F , K E S ) )	R M N V F K E S
copy ( B B C )	B B C
append ( A T L W , U N J )	A T L W U N J
prepend ( X I Z , echo ( D L B ) )	D L B B X I Z
append ( O R W V , K S N )	O R W V K S N
reverse ( F E A I )	I A E F
append ( H B , L Q )	H B L Q
copy ( K J )	K J
reverse ( echo ( Y N ) )	N N Y
prepend ( C B B , echo ( V D N X ) )	V D N X X C B B
copy ( shift ( P B D ) )	B D P
append ( X D E P , M U )	X D E P M U
prepend ( V C N V , append ( I L F , X F D ) )	I L F X F D V C N V
echo ( prepend ( S J K , T P P A ) )	T P P A S J K K
copy ( reverse ( I H I ) )	I H I
shift ( H B V G )	B V G H
copy ( T T G M )	T T G M
reverse ( F H )	H F
echo ( F X U )	F X U U
append ( N N R J , I K C )	N N R J I K C
reverse ( I V E )	E V I
shift ( V Z A )	Z A V
echo ( prepend ( C O , reverse ( D G N ) ) )	N G D C O O
copy ( E S E C )	E S E C
echo ( L L C P )	L L C P P
echo ( prepend ( reverse ( R J ) , echo ( J E ) ) )	J E E J R R
echo ( Z N V )	Z N V V
echo ( reverse ( G K W ) )	W K G G
prepend ( reverse ( B T X ) , shift ( D P C ) )	P C D X T B
shift ( C D U Y )	D U Y C
shift ( echo ( O Q ) )	Q Q O
copy ( G N S H )	G N S H
reverse ( C I E R )	R E I C
shift ( X O )	O X
echo ( E C G )	E C G G
reverse ( D U B )	B U D
echo ( F M )	F M M
echo ( copy ( Q H Y ) )	Q H Y Y
reverse ( shift ( U E A ) )	U A E
echo ( L A Q F )	L A Q F F
shift ( R N )	N R
reverse ( A A Z )	Z A A
shift ( H Y G )	Y G H
shift ( N I R Z )	I R Z N
append ( append ( A N V , K J Z ) , copy ( B W S P ) )	A N V K J Z B W S P
copy ( T V M K )	T V M K
reverse ( Q I E T )	T E I Q
copy ( T H U L )	T H U L
reverse ( W X )	X W
copy ( G U )	G U
copy ( C M )	C M
shift ( E A )	A E
copy ( E E )	E E
echo ( J H Z )	J H Z Z
reverse ( T E )	E T
shift ( O M X )	M X O
reverse ( copy ( S C ) )	C S
prepend ( J J W K , reverse ( G N ) )	N G J J W K
echo ( T I )	T I I
reverse ( copy ( O A G F ) )	F G A O
echo ( U M )	U M M
copy ( N W )	N W
shift ( copy ( E V ) )	V E
reverse ( F K P Q )	Q P K F
shift ( shift ( X W P ) )	P X W
shift ( U C H )	C H U
echo ( K X Y )	K X Y Y
reverse ( reverse ( J V O M ) )	J V O M
echo ( I D )	I D D
shift ( shift ( K H O T ) )	O T K H
reverse ( L S V )	V S L
reverse ( H X M )	M X H
copy ( G M N )	G M N
shift ( G Z J )	Z J G
append ( I I E , P V P S )	I I E P V P S
shift ( echo ( H D S K ) )	D S K K H
reverse ( append ( reverse ( B J T X ) , B K ) )	K B B J T X
shift ( O U )	U O
shift ( echo ( D A I ) )	A I I D
shift ( reverse ( D K Z M ) )	Z K D M
copy ( echo ( A I I C ) )	A I I C C
append ( shift ( R Z Y ) , R G P )	Z Y R R G P
copy ( shift ( reverse ( E P ) ) )	E P
echo ( J T G X )	J T G X X
shift ( echo ( shift ( copy ( H D C ) ) ) )	C H H D
prepend ( shift ( V I E D ) , copy ( A G U ) )	A G U I E D V
echo ( shift ( Q P ) )	P Q Q
reverse ( K H )	H K
echo ( S R C )	S R C C
prepend ( A J , O T W )	O T W A J
shift ( B C U R )	C U R B
reverse ( H D )	D H
append ( A K S B , append ( copy ( Q O ) , echo ( Y I L ) ) )	A K S B Q O Y I L L
reverse ( Q Q Z )	Z Q Q
shift ( J D Y )	D Y J
append ( D R O , U K )	D R O U K
reverse ( G H )	H G
prepend ( C O A , X P K )	X P K C O A
reverse ( Y E I L )	L I E Y
reverse ( T W )	W T
shift ( reverse ( Z J Y ) )	J Z Y
echo ( S H )	S H H
reverse ( I Q D P )	P D Q I
prepend ( D U P H , M X )	M X D U P H
reverse ( E J S A )	A S J E
copy ( echo ( H B L ) )	H B L L
reverse ( prepend ( shift ( N C X S ) , X G ) )	N S X C G X
append ( J H M L , append ( S A L , S W J ) )	J H M L S A L S W J
reverse ( append ( B N M C , H G C T ) )	T C G H C M N B
echo ( S Z )	S Z Z
echo ( F X C )	F X C C
echo ( C P M )	C P M M
copy ( I X M )	I X M
echo ( E L V )	E L V V
append ( J M P , D E )	J M P D E
prepend ( F B , copy ( C N Q ) )	C N Q F B
copy ( R I Y G )	R I Y G
prepend ( G N Q U , I T Y )	I T Y G N Q U
echo ( Z E P U )	Z E P U U
copy ( H I B A )	H I B A
reverse ( U U Z )	Z U U
reverse ( N I )	I N
shift ( B F N )	F N B
reverse ( O V H )	H V O
copy ( D X C Y )	D X C Y
shift ( J T Z )	T Z J
prepend ( T H D B , copy ( echo ( T K U ) ) )	T K U U T H D B
reverse ( copy ( reverse ( A K D H ) ) )	A K D H
append ( prepend ( D D , copy ( C V H ) ) , I O Y )	C V H D D I O Y
echo ( copy ( W G W R ) )	W G W R R
reverse ( F M B )	B M F
reverse ( F A S )	S A F
copy ( C R I Z )	C R I Z
shift ( J B L )	B L J
append ( F Q E , R V G )	F Q E R V G
copy ( shift ( E N H T ) )	N H T E
prepend ( T F , Z I )	Z I T F
shift ( K T )	T K
shift ( P E D )	E D P
append ( D F O N , N Y )	D F O N N Y
shift ( K Q L )	Q L K
shift ( echo ( U Q ) )	Q Q U
append ( H P R , F P Q Q )	H P R F P Q Q
reverse ( U R N )	N R U
copy ( S X )	S X
append ( G L L , prepend ( X M H R , N Z Q S ) )	G L L N Z Q S X M H R
shift ( U H V )	H V U
prepend ( T X , J G Q )	J G Q T X
shift ( J Q )	Q J
prepend ( X M , Y S G )	Y S G X M
copy ( Q B H E )	Q B H E
shift ( F K F O )	K F O F
prepend ( R G H M , echo ( V Z ) )	V Z Z R G H M
prepend ( F V , reverse ( S R F A ) )	A F R S F V
shift ( I P V )	P V I
shift ( Q Z )	Z Q
reverse ( S V )	V S
shift ( Y S )	S Y
shift ( D Q T )	Q T D
shift ( shift ( B Y ) )	B Y
copy ( G L V )	G L V
shift ( reverse ( echo ( X H R ) ) )	R H X R
shift ( reverse ( G F B ) )	F G B
prepend ( O P W , L W Q )	L W Q O P W
prepend ( T B I , S J S Q )	S J S Q T B I
shift ( Q J Y I )	J Y I Q
copy ( B I )	B I
echo ( Y K U G )	Y K U G G
prepend ( M E L C , C J U )	C J U M E L C
shift ( Z E X V )	E X V Z
shift ( O X K )	X K O
prepend ( V D , Q T Z A )	Q T Z A V D
reverse ( echo ( U F C ) )	C C F U
prepend ( J N Q S , S D S W )	S D S W J N Q S
shift ( A D )	D A
echo ( S D J )	S D J J
append ( N G L M , J Y R )	N G L M J Y R
shift ( L E V )	E V L
copy ( T D O F )	T D O F
reverse ( I I )	I I
echo ( shift ( G B K T ) )	B K T G G
shift ( E I )	I E
copy ( R X H P )	R X H P
echo ( S O J C )	S O J C C
shift ( shift ( C S K ) )	K C S
copy ( L E Q )	L E Q
shift ( F D K S )	D K S F
shift ( Q Q Y )	Q Y Q
prepend ( T X A Q , T E L )	T E L T X A Q
echo ( E Z Z )	E Z Z Z
echo ( C S H Z )	C S H Z Z
prepend ( U K J , W L E )	W L E U K J
append ( G O , K K Y J )	G O K K Y J
reverse ( Q U N N )	N N U Q
reverse ( D W )	W D
prepend ( A Q M L , H K Q )	H K Q A Q M L
reverse ( T O )	O T
shift ( H Z )	Z H
append ( N V , Q U G F )	N V Q U G F
shift ( P A )	A P
echo ( echo ( D A J T ) )	D A J T T T
shift ( C G D T )	G D T C
prepend ( H N M D , A L O )	A L O H N M D
reverse ( N U )	U N
prepend ( A M Q , echo ( B X ) )	B X X A M Q
copy ( V P N K )	V P N K
prepend ( F P I P , O X Y O )	O X Y O F P I P
echo ( shift ( Z B Z ) )	B Z Z Z
prepend ( D A D , prepend ( L O G , O V F ) )	O V F L O G D A D
append ( V Y D , Y J G )	V Y D Y J G
shift ( echo ( N L O B ) )	L O B B N
shift ( N H )	H N
copy ( S Y B )	S Y B
reverse ( P F U I )	I U F P
reverse ( L X H K )	K H X L
copy ( Q J Q W )	Q J Q W
echo ( reverse ( S F ) )	F S S
shift ( shift ( prepend ( Z Q , A S U N ) ) )	U N Z Q A S
echo ( U P G )	U P G G
echo ( P G V )	P G V V
copy ( X Y Q F )	X Y Q F
shift ( O M )	M O
reverse ( V H S )	S H V
copy ( copy ( H M ) )	H M
echo ( D V S E )	D V S E E
reverse ( copy ( reverse ( F V A S ) ) )	F V A S
reverse ( reverse ( X L I J ) )	X L I J
prepend ( P U K M , J P M L )	J P M L P U K M
append ( Z R M R , Z X )	Z R M R Z X
copy ( prepend ( N D W , Q I L ) )	Q I L N D W
copy ( M J F Q )	M J F Q
echo ( Y B )	Y B B
prepend ( S R , E F K )	E F K S R
copy ( shift ( Y D F ) )	D F Y
shift ( L I T F )	I T F L
copy ( V C )	V C
reverse ( B C D )	D C B
prepend ( L Z N , M R Z )	M R Z L Z N
reverse ( copy ( F J M Z ) )	Z M J F
echo ( J J )	J J J
copy ( K D Z )	K D Z
echo ( echo ( K E ) )	K E E E
echo ( Y H M )	Y H M M
reverse ( K W )	W K
append ( O R , append ( G L , V C B P ) )	O R G L V C B P
copy ( echo ( K Z ) )	K Z Z
append ( append ( C Y R , append ( prepend ( O F L G , shift ( D O ) ) , K M M ) ) , W F D )	C Y R O D O F L G K M M W F D
echo ( D F O B )	D F O B B
echo ( C S A )	C S A A
shift ( G L G )	L G G
prepend ( P O J P , Y E )	Y E P O J P
shift ( S J A W )	J A W S
reverse ( S Y )	Y S
prepend ( B R M Z , S K T )	S K T B R M Z
shift ( B F N R )	F N R B
append ( J O Y , N S R E )	J O Y N S R E
shift ( T Z L B )	Z L B T
copy ( A A P O )	A A P O
copy ( S E G S )	S E G S
prepend ( copy ( D H D ) , X X L )	X X L D H D
prepend ( reverse ( I N L E ) , B I B )	B I B E L N I
echo ( reverse ( H S ) )	S H H
append ( P W U L , Q Q )	P W U L Q Q
copy ( N Y E )	N Y E
shift ( A E G )	E G A
reverse ( E B A B )	B A B E
echo ( M P )	M P P
echo ( D D W )	D D W W
reverse ( P G F K )	K F G P
echo ( G Q U )	G Q U U
echo ( A R )	A R R
echo ( echo ( Q I ) )	Q I I I
echo ( C R X U )	C R X U U
reverse ( J X K )	K X J
shift ( R R M )	R M R
echo ( E A E M )	E A E M M
copy ( Y S S )	Y S S
prepend ( copy ( shift ( P M ) ) , O W Z )	O W Z M P
echo ( N I D )	N I D D
reverse ( echo ( M M C U ) )	U U C M M
reverse ( Q T F T )	T F T Q
reverse ( copy ( G S M O ) )	O M S G
append ( Z D G , M O I )	Z D G M O I
shift ( W B B X )	B B X W
echo ( S G B I )	S G B I I
reverse ( C Y T )	T Y C
append ( X E C K , K G )	X E C K K G
append ( R D , copy ( J C P T ) )	R D J C P T
echo ( copy ( R Q J H ) )	R Q J H H
reverse ( K I A )	A I K
echo ( Z Y F J )	Z Y F J J
reverse ( prepend ( copy ( W D ) , S G ) )	D W G S
echo ( copy ( echo ( N N L Z ) ) )	N N L Z Z Z
shift ( F B R )	B R F
shift ( S D )	D S
reverse ( F Q E Y )	Y E Q F
reverse ( reverse ( X L ) )	X L
append ( shift ( reverse ( G M K V ) ) , X B )	K M G V X B
prepend ( R C N A , O L J )	O L J R C N A
append ( X T R , K A M D )	X T R K A M D
shift ( F F Z T )	F Z T F
copy ( K Z O O )	K Z O O
append ( Q S K , Y E E )	Q S K Y E E
prepend ( V Q X W , append ( echo ( prepend ( echo ( E J T ) , M K B V ) ) , N V M ) )	M K B V E J T T T N V M V Q X W
prepend ( C U , R K Z S )	R K Z S C U
reverse ( prepend ( G M T , copy ( Y J Y Y ) ) )	T M G Y Y J Y
prepend ( Q Y P , H W J P )	H W J P Q Y P
prepend ( N K W R , A B C )	A B C N K W R
copy ( O G B M )	O G B M
reverse ( I A V N )	N V A I
copy ( W K )	W K
append ( X Z N W , I T E O )	X Z N W I T E O
echo ( P U )	P U U
copy ( M C E B )	M C E B
reverse ( F S F )	F S F
reverse ( K A )	A K
reverse ( append ( Y O J , copy ( Y E U Y ) ) )	Y U E Y J O Y
reverse ( O F F D )	D F F O
copy ( reverse ( L G V R ) )	R V G L
shift ( R D O )	D O R
echo ( S D V U )	S D V U U
reverse ( P A J Q )	Q J A P
prepend ( shift ( V G A ) , N Z K H )	N Z K H G A V
prepend ( M T F , L K H )	L K H M T F
reverse ( F R O )	O R F
prepend ( I D X , Y O N A )	Y O N A I D X
echo ( echo ( Q X T ) )	Q X T T T
copy ( I V P )	I V P
reverse ( I X X C )	C X X I
echo ( F N R B )	F N R B B
shift ( L D F )	D F L
append ( Y V , F Q C V )	Y V F Q C V
copy ( P Z K D )	P Z K D
reverse ( copy ( W E J X ) )	X J E W
reverse ( T F D E )	E D F T
prepend ( reverse ( N D ) , M K A B )	M K A B D N
echo ( copy ( K F S B ) )	K F S B B
reverse ( B W A S )	S A W B
prepend ( reverse ( Q D L O ) , N M J )	N M J O L D Q
echo ( Z E )	Z E E
copy ( E N W )	E N W
echo ( J E R )	J E R R
reverse ( X U N X )	X N U X
copy ( prepend ( A D C F , prepend ( L Q Z , M L K K ) ) )	M L K K L Q Z A D C F
reverse ( prepend ( L D N , B R J M ) )	N D L M J R B
shift ( prepend ( S E G T , M D X S ) )	D X S S E G T M
append ( Y X E , P S )	Y X E P S
append ( N K , G M )	N K G M
echo ( T W T V )	T W T V V
shift ( I U )	U I
shift ( prepend ( shift ( N L I ) , copy ( N J N R ) ) )	J N R L I N N
echo ( O Q B P )	O Q B P P
copy ( append ( N X I Z , X J E ) )	N X I Z X J E
shift ( K F )	F K
echo ( N N U )	N N U U
shift ( X C H L )	C H L X
echo ( Y T O )	Y T O O
copy ( M A M )	M A M
shift ( Z I Z L )	I Z L Z
reverse ( echo ( S H A ) )	A A H S
reverse ( W C P C )	C P C W
echo ( H K W N )	H K W N N
prepend ( C R , W W )	W W C R
append ( M P F H , L F W I )	M P F H L F W I
append ( append ( append ( C G , I B X ) , H Y X Y ) , S F A N )	C G I B X H Y X Y S F A N
reverse ( N Q C L )	L C Q N
prepend ( Y P , P Z E N )	P Z E N Y P
append ( N J N , P O S X )	N J N P O S X
shift ( O P )	P O
reverse ( M T A J )	J A T M
append ( C I E , V X )	C I E V X
copy ( F T D )	F T D
echo ( C N J K )	C N J K K
reverse ( U S O G )	G O S U
copy ( T I B )	T I B
shift ( F D L )	D L F
reverse ( N G F Z )	Z F G N
reverse ( copy ( echo ( echo ( Y P C ) ) ) )	C C C P Y
copy ( A B V )	A B V
copy ( O Y O )	O Y O
copy ( E U H )	E U H
echo ( D I Z )	D I Z Z
echo ( copy ( S P C ) )	S P C C
reverse ( shift ( W J ) )	W J
reverse ( F O C )	C O F
prepend ( reverse ( N X ) , A A Y Y )	A A Y Y X N
append ( N O , reverse ( shift ( T V H X ) ) )	N O T X H V
echo ( reverse ( H S B ) )	B S H H
copy ( D Y A )	D Y A
prepend ( U B M , L A )	L A U B M
shift ( echo ( prepend ( P F F , M D C ) ) )	D C P F F F M
copy ( H E L )	H E L
prepend ( prepend ( reverse ( U F ) , K V Y W ) , J D Z P )	J D Z P K V Y W F U
shift ( X U I B )	U I B X
echo ( B Q K A )	B Q K A A
echo ( H F B X )	H F B X X
echo ( reverse ( C T T ) )	T T C C
prepend ( W Y , append ( prepend ( copy ( U D B M ) , G Y K ) , U T ) )	G Y K U D B M U T W Y
append ( V L S M , X F K )	V L S M X F K
echo ( C D G N )	C D G N N
shift ( J T )	T J
echo ( shift ( U Y Z ) )	Y Z U U
prepend ( R F E , F K N )	F K N R F E
append ( prepend ( U X , W H ) , J M E H )	W H U X J M E H
copy ( shift ( L G ) )	G L
shift ( J R Z R )	R Z R J
append ( G N O P , K D M )	G N O P K D M
reverse ( echo ( prepend ( F W Q T , shift ( E R ) ) ) )	T T Q W F E R
copy ( K J V )	K J V
shift ( S B V G )	B V G S
copy ( F F )	F F
echo ( U T S B )	U T S B B
echo ( reverse ( prepend ( R D X , P G U T ) ) )	X D R T U G P P
echo ( shift ( reverse ( U B ) ) )	U B B
shift ( L L O )	L O L
echo ( Z Z B A )	Z Z B A A
shift ( E C J )	C J E
copy ( echo ( shift ( W C T ) ) )	C T W W
reverse ( W M X )	X M W
prepend ( S O P C , Z D P D )	Z D P D S O P C
shift ( G C S )	C S G
shift ( X G D )	G D X
append ( E V H X , echo ( shift ( Z T I L ) ) )	E V H X T I L Z Z
prepend ( T K O D , R B O )	R B O T K O D
prepend ( C E N , S F W U )	S F W U C E N
shift ( U W C )	W C U
append ( Z J V , O B )	Z J V O B
append ( echo ( O K Z Q ) , I W D W )	O K Z Q Q I W D W
reverse ( A F D L )	L D F A
shift ( M D )	D M
shift ( append ( N M N , reverse ( copy ( Z I X K ) ) ) )	M N K X I Z N
copy ( Z K E O )	Z K E O
copy ( echo ( M F Y X ) )	M F Y X X
reverse ( U D S )	S D U
shift ( echo ( P C ) )	C C P
append ( shift ( P T E N ) , append ( prepend ( V M , P J ) , C D U ) )	T E N P P J V M C D U
shift ( O P F U )	P F U O
prepend ( shift ( H W R W ) , E Z V )	E Z V W R W H
copy ( L H Q W )	L H Q W
copy ( J G )	J G
echo ( reverse ( O N Y M ) )	M Y N O O
reverse ( A F Y R )	R Y F A
copy ( Q F )	Q F
copy ( Q P O )	Q P O
shift ( shift ( shift ( C S ) ) )	S C
shift ( H U C R )	U C R H
echo ( prepend ( shift ( echo ( Y U Z ) ) , copy ( A U ) ) )	A U U Z Z Y Y
append ( append ( Q E R K , L O F A ) , shift ( H B F L ) )	Q E R K L O F A B F L H
echo ( P V )	P V V
copy ( prepend ( T S R , N L G ) )	N L G T S R
echo ( E D X W )	E D X W W
prepend ( Q Y A A , M Y X )	M Y X Q Y A A
shift ( V P C )	P C V
append ( R N Y G , Y Y G M )	R N Y G Y Y G M
reverse ( shift ( T F V ) )	T V F
echo ( echo ( X T ) )	X T T T
shift ( O H V )	H V O
copy ( C F X F )	C F X F
prepend ( N H F , shift ( E D ) )	D E N H F
copy ( echo ( L R W C ) )	L R W C C
shift ( T S S )	S S T
shift ( K Y M )	Y M K
append ( K Y K , X Z J )	K Y K X Z J
append ( T F S , Z H N N )	T F S Z H N N
append ( Y U D , shift ( E A V A ) )	Y U D A V A E
shift ( S L )	L S
reverse ( N K Q Z )	Z Q K N
copy ( V W )	V W
copy ( B C C D )	B C C D
copy ( X N )	X N
append ( N Q H , prepend ( U S O Z , append ( D C T Y , M C B X ) ) )	N Q H D C T Y M C B X U S O Z
append ( A Y B M , Y T )	A Y B M Y T
copy ( append ( shift ( V K U ) , U U ) )	K U V U U
echo ( I V O )	I V O O
prepend ( N L P E , copy ( R C ) )	R C N L P E
echo ( prepend ( Q O X , shift ( F E ) ) )	E F Q O X X
append ( S P N , L P O Z )	S P N L P O Z
echo ( L Z N A )	L Z N A A
copy ( C V )	C V
copy ( R B U )	R B U
shift ( Z V C )	V C Z
shift ( H M U K )	M U K H
append ( Z E P Q , L R W A )	Z E P Q L R W A
reverse ( U D )	D U
append ( E R K , U O Y )	E R K U O Y
echo ( A X K )	A X K K
append ( reverse ( D A Y ) , J E A O )	Y A D J E A O
append ( J W N , X U E )	J W N X U E
echo ( I R F )	I R F F
append ( L P S , prepend ( T H Z W , G O I A ) )	L P S G O I A T H Z W
reverse ( G S D I )	I D S G
append ( K P D A , shift ( G A P ) )	K P D A A P G
prepend ( S L E , E D W )	E D W S L E
reverse ( Y G )	G Y
reverse ( append ( A Q , K Y H ) )	H Y K Q A
append ( W W Q , Y H V M )	W W Q Y H V M
copy ( B B K )	B B K
prepend ( F M Z , W O A H )	W O A H F M Z
shift ( append ( prepend ( A R D H , W R F ) , I Y ) )	R F A R D H I Y W
reverse ( K N N E )	E N N K
prepend ( M D P , F C P )	F C P M D P
copy ( shift ( U W W O ) )	W W O U
copy ( prepend ( M X P , K S ) )	K S M X P
prepend ( N B , K D Q P )	K D Q P N B
shift ( H S Y )	S Y H
append ( P T W , P R T X )	P T W P R T X
copy ( D K Z )	D K Z
prepend ( Y W , I J )	I J Y W
shift ( S K D T )	K D T S
shift ( C Q )	Q C
reverse ( prepend ( echo ( H Z O I ) , D J E Z ) )	I I O Z H Z E J D
append ( Y M T L , shift ( Z T G L ) )	Y M T L T G L Z
shift ( H S O E )	S O E H
prepend ( copy ( Q M ) , shift ( reverse ( G Z L N ) ) )	L Z G N Q M
prepend ( R K Q , X U X )	X U X R K Q
echo ( W E )	W E E
append ( N N J J , Z R R )	N N J J Z R R
reverse ( V E I )	I E V
reverse ( W B Z D )	D Z B W
copy ( Y N W )	Y N W
copy ( X C )	X C
echo ( Q S N M )	Q S N M M
reverse ( Q U )	U Q
append ( D D F , shift ( U B Y ) )	D D F B Y U
shift ( Q Q R U )	Q R U Q
append ( W F D G , J M G V )	W F D G J M G V
echo ( G Y B O )	G Y B O O
copy ( I P L L )	I P L L
prepend ( U G , I O W T )	I O W T U G
copy ( O A H J )	O A H J
copy ( copy ( J K L M ) )	J K L M
shift ( prepend ( F X B O , append ( reverse ( K K R ) , C H A C ) ) )	K K C H A C F X B O R
echo ( K J P F )	K J P F F
copy ( Y S J N )	Y S J N
copy ( B U Z O )	B U Z O
reverse ( S Q D )	D Q S
copy ( shift ( shift ( O C I ) ) )	I O C
copy ( echo ( Z E D W ) )	Z E D W W
reverse ( E R F O )	O F R E
append ( B X U , H L C G )	B X U H L C G
copy ( V U )	V U
echo ( C M Y B )	C M Y B B
copy ( N C P C )	N C P C
append ( D J M , Y R Q )	D J M Y R Q
reverse ( prepend ( Z O B C , U G K V ) )	C B O Z V K G U
append ( echo ( W V Z ) , F R J )	W V Z Z F R J
echo ( B F T )	B F T T
shift ( W G Q I )	G Q I W
append ( B G , F D D A )	B G F D D A
shift ( I S )	S I
prepend ( N Z , H N T )	H N T N Z
reverse ( X B E )	E B X
append ( K D H , H Z P R )	K D H H Z P R
copy ( K M U )	K M U
echo ( G I H )	G I H H
copy ( shift ( E W Y G ) )	W Y G E
append ( S V I , reverse ( append ( D U A T , V V V V ) ) )	S V I V V V V T A U D
prepend ( M Q E U , prepend ( G Q , L P D S ) )	L P D S G Q M Q E U
echo ( H C W )	H C W W
reverse ( I W )	W I
echo ( G S J )	G S J J
copy ( reverse ( Y S T G ) )	G T S Y
reverse ( U C T S )	S T C U
copy ( W B V D )	W B V D
copy ( K F R E )	K F R E
copy ( Q V H )	Q V H
echo ( copy ( prepend ( shift ( W Z E K ) , T P ) ) )	T P Z E K W W
prepend ( copy ( E U M ) , S X I W )	S X I W E U M
echo ( B W )	B W W
copy ( Z D I M )	Z D I M
copy ( Q F M V )	Q F M V
reverse ( shift ( shift ( E N P ) ) )	N E P
append ( L O Z , Z Z )	L O Z Z Z
echo ( copy ( Y S E M ) )	Y S E M M
echo ( A Z L H )	A Z L H H
reverse ( C F H Y )	Y H F C
prepend ( P Z , W T N )	W T N P Z
echo ( J X M B )	J X M B B
copy ( D G R )	D G R
prepend ( echo ( G U J Y ) , P I X L )	P I X L G U J Y Y
prepend ( Y F O B , C X )	C X Y F O B
shift ( O V K V )	V K V O
append ( E C I J , copy ( D Q K ) )	E C I J D Q K
append ( Z F I , K J Y K )	Z F I K J Y K
shift ( Y Q B P )	Q B P Y
reverse ( Y U F M )	M F U Y
reverse ( prepend ( M C , L J H ) )	C M H J L
shift ( S K O )	K O S
echo ( K H R )	K H R R
copy ( X I E R )	X I E R
reverse ( copy ( Q J K E ) )	E K J Q
copy ( X Z C )	X Z C
reverse ( prepend ( shift ( C B ) , echo ( append ( U M N , echo ( P T S L ) ) ) ) )	C B L L L S T P N M U
reverse ( X L B )	B L X
prepend ( Q V R Y , C Q A )	C Q A Q V R Y
copy ( H J H )	H J H
append ( Y P W F , copy ( I S U ) )	Y P W F I S U
copy ( D L C R )	D L C R
shift ( echo ( shift ( O V X W ) ) )	X W O O V
reverse ( H L T I )	I T L H
shift ( K L )	L K
append ( Z G T U , J E P D )	Z G T U J E P D
append ( I A Y , Z S )	I A Y Z S
shift ( U P )	P U
copy ( echo ( F F A T ) )	F F A T T
copy ( C E T P )	C E T P
shift ( P T B V )	T B V P
copy ( echo ( D W N ) )	D W N N
echo ( K U E )	K U E E
shift ( echo ( shift ( T T F ) ) )	F T T T
echo ( G J N )	G J N N
reverse ( P A T )	T A P
echo ( P Q K Q )	P Q K Q Q
echo ( B Q I )	B Q I I
append ( O S I T , I P )	O S I T I P
copy ( S I N )	S I N
append ( Z P O , D P A )	Z P O D P A
copy ( R A )	R A
echo ( Y G N )	Y G N N
copy ( U T T H )	U T T H
append ( I R W , shift ( B A L X ) )	I R W A L X B
append ( F J , N Z J )	F J N Z J
reverse ( M G X F )	F X G M
shift ( M Z )	Z M
prepend ( W N C , I D E )	I D E W N C
shift ( prepend ( reverse ( copy ( G C Y H ) ) , D T N P ) )	T N P H Y C G D
echo ( E S C G )	E S C G G
echo ( Q J )	Q J J
copy ( G E O K )	G E O K
prepend ( U T W , copy ( shift ( C E B ) ) )	E B C U T W
copy ( B X U Y )	B X U Y
shift ( echo ( reverse ( O T ) ) )	O O T
append ( D V , shift ( H R L ) )	D V R L H
shift ( L J Z M )	J Z M L
reverse ( W G H )	H G W
prepend ( X Z , R T F )	R T F X Z
echo ( W S )	W S S
append ( V S M X , W N T )	V S M X W N T
copy ( S H T S )	S H T S
reverse ( J P J )	J P J
append ( U O Z , shift ( E M ) )	U O Z M E
append ( P S T , Y F N )	P S T Y F N
reverse ( N A Y Z )	Z Y A N
reverse ( Y L Y M )	M Y L Y
echo ( J E H )	J E H H
shift ( G O M B )	O M B G
copy ( I V Y O )	I V Y O
prepend ( R Z N , N S )	N S R Z N
echo ( Z E V G )	Z E V G G
reverse ( G E R )	R E G
echo ( H U )	H U U
shift ( T P V I )	P V I T
copy ( copy ( B L Y D ) )	B L Y D
echo ( Z M )	Z M M
reverse ( V R I W )	W I R V
echo ( D Y K )	D Y K K
shift ( E G B )	G B E
copy ( H M T V )	H M T V
reverse ( Q C )	C Q
echo ( W A )	W A A
copy ( prepend ( reverse ( S W D V ) , E V P ) )	E V P V D W S
copy ( K U B D )	K U B D
append ( A M J Z , B Q V H )	A M J Z B Q V H
shift ( shift ( N L O ) )	O N L
append ( reverse ( H K L C ) , N J )	C L K H N J
shift ( V J J )	J J V
prepend ( I O O U , T D F )	T D F I O O U
append ( G S R , V O H P )	G S R V O H P
append ( M T A Q , copy ( X F ) )	M T A Q X F
copy ( B M )	B M
shift ( X W C Q )	W C Q X
echo ( W G N W )	W G N W W
copy ( T A R )	T A R
reverse ( E T )	T E
copy ( echo ( J X D ) )	J X D D
append ( D I , append ( append ( R T C , B E N ) , L F Q ) )	D I R T C B E N L F Q
prepend ( prepend ( N D R , append ( R D A Z , C U G ) ) , copy ( X K W ) )	X K W R D A Z C U G N D R
echo ( O H K L )	O H K L L
copy ( T F X )	T F X
copy ( copy ( E Z ) )	E Z
reverse ( shift ( T L B O ) )	T O B L
prepend ( F V B , E S G )	E S G F V B
prepend ( S L G P , W O )	W O S L G P
reverse ( shift ( copy ( shift ( Y P N B ) ) ) )	P Y B N
shift ( L H W )	H W L
echo ( copy ( O W Y ) )	O W Y Y
copy ( P Q B D )	P Q B D
append ( C N L , prepend ( shift ( U P I ) , echo ( echo ( G F T ) ) ) )	C N L G F T T T P I U
reverse ( append ( B A V Q , Y H ) )	H Y Q V A B
shift ( K Y Q A )	Y Q A K
copy ( copy ( H O N ) )	H O N
echo ( J R Y )	J R Y Y
append ( J T X P , prepend ( echo ( F E E G ) , I F ) )	J T X P I F F E E G G
echo ( T Y K )	T Y K K
prepend ( P W M P , K C Y R )	K C Y R P W M P
prepend ( S Q E A , J I P )	J I P S Q E A
copy ( J N G G )	J N G G
copy ( L L K )	L L K
prepend ( echo ( P L ) , J H B U )	J H B U P L L
shift ( copy ( Y V D P ) )	V D P Y
echo ( U O Y O )	U O Y O O
prepend ( Z O C M , copy ( Z E H L ) )	Z E H L Z O C M
reverse ( H K V )	V K H
copy ( prepend ( N N A , X U Q S ) )	X U Q S N N A
copy ( L L )	L L
append ( L H , P Z H )	L H P Z H
append ( A O , Z S G )	A O Z S G
echo ( Y A H )	Y A H H
prepend ( T H , H J G E )	H J G E T H
echo ( echo ( E Z K ) )	E Z K K K
reverse ( Z C S O )	O S C Z
prepend ( Y Y O V , N C )	N C Y Y O V
echo ( S E O J )	S E O J J
prepend ( F W G , R Y S O )	R Y S O F W G
prepend ( M N , G C A G )	G C A G M N
shift ( B I G K )	I G K B
copy ( A J X H )	A J X H
prepend ( D D H , reverse ( U S F D ) )	D F S U D D H
copy ( B L O )	B L O
append ( P X S O , A U K A )	P X S O A U K A
prepend ( echo ( N P I R ) , C H N )	C H N N P I R R
echo ( H Q Y G )	H Q Y G G
copy ( V S F I )	V S F I
prepend ( reverse ( X I ) , echo ( O N W N ) )	O N W N N I X
copy ( E B U X )	E B U X
reverse ( prepend ( copy ( D F P Z ) , B F U ) )	Z P F D U F B
reverse ( F U Q )	Q U F
append ( O G C , copy ( reverse ( shift ( append ( copy ( copy ( F E R ) ) , reverse ( G P G ) ) ) ) ) )	O G C F G P G R E
append ( S D V , L B M O )	S D V L B M O
reverse ( R G T Q )	Q T G R
reverse ( O N A )	A N O
shift ( Y L D )	L D Y
shift ( I E K Y )	E K Y I
copy ( reverse ( C X J J ) )	J J X C
shift ( X S H )	S H X
echo ( copy ( copy ( U U E O ) ) )	U U E O O
reverse ( K R Q P )	P Q R K
prepend ( S E D X , X N T O )	X N T O S E D X
echo ( U I P )	U I P P
shift ( U D N K )	D N K U
append ( T G N U , U M H K )	T G N U U M H K
append ( shift ( reverse ( C N A I ) ) , C T W H )	A N C I C T W H
echo ( M J V )	M J V V
shift ( U T Q )	T Q U
echo ( J H W C )	J H W C C
reverse ( L N Q T )	T Q N L
shift ( V Y G T )	Y G T V
shift ( T Z V B )	Z V B T
append ( W R J , reverse ( T S ) )	W R J S T
copy ( V B )	V B
shift ( D L G )	L G D
echo ( echo ( echo ( P R A V ) ) )	P R A V V V V
reverse ( P H K X )	X K H P
copy ( E S X )	E S X
echo ( L R O O )	L R O O O
echo ( E P J )	E P J J
reverse ( prepend ( N T , append ( K K B , X K P Y ) ) )	T N Y P K X B K K
copy ( I R D C )	I R D C
echo ( B L G )	B L G G
shift ( O U J T )	U J T O
copy ( V V W )	V V W
copy ( A B S )	A B S
copy ( V H K )	V H K
reverse ( H R W F )	F W R H
reverse ( T U H )	H U T
append ( F W X , F C F F )	F W X F C F F
append ( E B R S , R Q L )	E B R S R Q L
copy ( O W D W )	O W D W
reverse ( F N P )	P N F
reverse ( H S Q )	Q S H
echo ( T Q L )	T Q L L
copy ( J R )	J R
echo ( D I W M )	D I W M M
append ( J W B D , S C F )	J W B D S C F
reverse ( reverse ( M S T ) )	M S T
echo ( V C J )	V C J J
append ( J W O , E E D W )	J W O E E D W
echo ( copy ( T K Q ) )	T K Q Q
prepend ( append ( D K N J , S B N ) , shift ( T J L ) )	J L T D K N J S B N
shift ( reverse ( R X R ) )	X R R
echo ( U E )	U E E
reverse ( N Q P )	P Q N
append ( E Z E , copy ( append ( copy ( S N ) , L R N ) ) )	E Z E S N L R N
append ( copy ( shift ( echo ( append ( Q V B , W X I K ) ) ) ) , Z B A H )	V B W X I K K Q Z B A H
copy ( C T S H )	C T S H
copy ( H G R )	H G R
copy ( E N U F )	E N U F
copy ( Z M N )	Z M N
shift ( echo ( Y S R ) )	S R R Y
echo ( G W )	G W W
prepend ( N V V W , G T D )	G T D N V V W
append ( U C W T , D W T )	U C W T D W T
prepend ( H D K , M J O F )	M J O F H D K
echo ( N F P )	N F P P
prepend ( reverse ( K Q W ) , O L L )	O L L W Q K
copy ( X T I )	X T I
copy ( H E Z )	H E Z
shift ( X G Q Q )	G Q Q X
copy ( G L F )	G L F
copy ( G C C X )	G C C X
reverse ( W X U )	U X W
append ( reverse ( N O P F ) , N V R F )	F P O N N V R F
echo ( N B M B )	N B M B B
copy ( B V U )	B V U
copy ( M E F )	M E F
append ( reverse ( R Z ) , W Q )	Z R W Q
copy ( V E )	V E
echo ( E B A L )	E B A L L
copy ( shift ( P C T H ) )	C T H P
prepend ( echo ( S Q W ) , shift ( append ( copy ( R R X ) , V I ) ) )	R X V I R S Q W W
echo ( K W Q )	K W Q Q
copy ( shift ( D N K A ) )	N K A D
echo ( E G P S )	E G P S S
reverse ( T M F )	F M T
echo ( S G P L )	S G P L L
copy ( prepend ( P N M K , K O P C ) )	K O P C P N M K
shift ( prepend ( V I F , N I O ) )	I O V I F N
reverse ( Q N W M )	M W N Q
echo ( J N T D )	J N T D D
copy ( W A I T )	W A I T
echo ( copy ( P O O W ) )	P O O W W
prepend ( copy ( E W ) , Q Z R X )	Q Z R X E W
reverse ( E D Q Y )	Y Q D E
reverse ( S C Y )	Y C S
shift ( L W E N )	W E N L
reverse ( P U K )	K U P
append ( copy ( I O G C ) , O T R )	I O G C O T R
reverse ( P N G D )	D G N P
append ( W L B B , shift ( shift ( N R ) ) )	W L B B N R
reverse ( echo ( shift ( C N A ) ) )	C C A N
copy ( L A U )	L A U
echo ( append ( copy ( prepend ( P P Y , C Q O ) ) , U S A ) )	C Q O P P Y U S A A
shift ( copy ( A P D ) )	P D A
echo ( Q P V )	Q P V V
reverse ( A G H O )	O H G A
echo ( K Z S W )	K Z S W W
reverse ( H V U )	U V H
shift ( Y J J Q )	J J Q Y
copy ( V O Y )	V O Y
prepend ( V K B , reverse ( J M ) )	M J V K B
echo ( U V X )	U V X X
copy ( L W )	L W
echo ( N I O L )	N I O L L
reverse ( V I Z )	Z I V
shift ( I M R B )	M R B I
prepend ( N Q , reverse ( Y M G L ) )	L G M Y N Q
shift ( O I C R )	I C R O
echo ( R X Q T )	R X Q T T
append ( Y Z G C , prepend ( reverse ( Q B R ) , O V ) )	Y Z G C O V R B Q
copy ( reverse ( reverse ( copy ( shift ( Z G G ) ) ) ) )	G G Z
copy ( N P O M )	N P O M
copy ( A R P )	A R P
reverse ( K X )	X K
append ( prepend ( K U I A , shift ( Z H D ) ) , G W E A )	H D Z K U I A G W E A
copy ( E D S )	E D S
shift ( shift ( prepend ( A T Q , S Z H W ) ) )	H W A T Q S Z
prepend ( L K , O M D )	O M D L K
shift ( shift ( S P O ) )	O S P
shift ( Y E N X )	E N X Y
echo ( K J X S )	K J X S S
echo ( copy ( J H Y ) )	J H Y Y
shift ( Z W V W )	W V W Z
shift ( R J O Z )	J O Z R
copy ( M Z R A )	M Z R A
reverse ( X Z O )	O Z X
echo ( shift ( shift ( L Y C U ) ) )	C U L Y Y
reverse ( Q W O Z )	Z O W Q
shift ( R R )	R R
append ( shift ( E Y V O ) , shift ( shift ( echo ( A O R ) ) ) )	Y V O E R R A O
shift ( Q A U R )	A U R Q
shift ( O L F W )	L F W O
copy ( W L R )	W L R
echo ( O Z L )	O Z L L
copy ( D C )	D C
append ( S L P F , N D M V )	S L P F N D M V
shift ( B P D )	P D B
echo ( Z V )	Z V V
reverse ( J N V )	V N J
copy ( echo ( U C H C ) )	U C H C C
reverse ( N F )	F N
echo ( O O X )	O O X X
reverse ( Y R O T )	T O R Y
shift ( echo ( T X V ) )	X V V T
append ( shift ( Q U T D ) , S F H F )	U T D Q S F H F
reverse ( T Q )	Q T
copy ( C T R U )	C T R U
echo ( C Z A F )	C Z A F F
copy ( E I C )	E I C
echo ( P V V )	P V V V
echo ( G P )	G P P
shift ( E H P I )	H P I E
reverse ( P M G R )	R G M P
reverse ( Q P Q H )	H Q P Q
reverse ( N H G Q )	Q G H N
copy ( prepend ( T V , O D O I ) )	O D O I T V
shift ( U Y G )	Y G U
shift ( shift ( P O ) )	P O
reverse ( L T O Z )	Z O T L
reverse ( X W I )	I W X
prepend ( S A G A , append ( P N X X , K T D V ) )	P N X X K T D V S A G A
echo ( B U )	B U U
echo ( J U )	J U U
echo ( P K C )	P K C C
shift ( Y T M E )	T M E Y
shift ( H Q M )	Q M H
shift ( P U Q )	U Q P
echo ( O J T C )	O J T C C
echo ( D L S T )	D L S T T
copy ( shift ( R V N ) )	V N R
copy ( G L A )	G L A
echo ( K M X C )	K M X C C
append ( X M N , F P M )	X M N F P M
append ( N J O , R L F )	N J O R L F
append ( E V G , C O O A )	E V G C O O A
append ( copy ( Y J C C ) , M A E T )	Y J C C M A E T
reverse ( E N )	N E
copy ( D A Z )	D A Z
echo ( O L Q )	O L Q Q
echo ( Z E L V )	Z E L V V
echo ( T E F U )	T E F U U
prepend ( S Z R O , M D L )	M D L S Z R O
shift ( E B I )	B I E
echo ( S V K S )	S V K S S
shift ( S P )	P S
shift ( shift ( Y O P X ) )	P X Y O
reverse ( Y A Z )	Z A Y
prepend ( S O O , R P A )	R P A S O O
prepend ( S X F , Q X W C )	Q X W C S X F
append ( append ( M F , I M ) , reverse ( reverse ( reverse ( K N Z ) ) ) )	M F I M Z N K
reverse ( H K P )	P K H
copy ( U O P )	U O P
reverse ( A S O )	O S A
prepend ( P S M , copy ( copy ( S U X ) ) )	S U X P S M
copy ( copy ( J G F ) )	J G F
copy ( prepend ( I R , shift ( Q D ) ) )	D Q I R
reverse ( R G U Z )	Z U G R
echo ( M S )	M S S
shift ( N J L Z )	J L Z N
echo ( J V R )	J V R R
reverse ( S Q Y )	Y Q S
reverse ( T K P G )	G P K T
prepend ( L B N Q , N L )	N L L B N Q
reverse ( Q R P Q )	Q P R Q
copy ( Q G )	Q G
echo ( K S G )	K S G G
shift ( V V B )	V B V
reverse ( J P )	P J
copy ( S X S )	S X S
echo ( H M M )	H M M M
reverse ( U O U I )	I U O U
copy ( I C Q M )	I C Q M
echo ( append ( H Q H , copy ( copy ( G F X ) ) ) )	H Q H G F X X
echo ( copy ( J B N ) )	J B N N
prepend ( N R R S , S H F )	S H F N R R S
reverse ( R B Q )	Q B R
copy ( V Z A Y )	V Z A Y
echo ( E I Y )	E I Y Y
append ( O O U O , reverse ( G X E ) )	O O U O E X G
echo ( V B T Q )	V B T Q Q
copy ( copy ( B V T ) )	B V T
append ( echo ( I Z ) , K D U A )	I Z Z K D U A
reverse ( K M Q Q )	Q Q M K
copy ( copy ( Z D ) )	Z D
shift ( G I J X )	I J X G
echo ( W Q K )	W Q K K
copy ( G T Y )	G T Y
echo ( N F E B )	N F E B B
shift ( B B P )	B P B
shift ( G Y )	Y G
shift ( O O W O )	O W O O
reverse ( J C S )	S C J
copy ( Q P A )	Q P A
append ( T Z , J E P )	T Z J E P
shift ( R A F P )	A F P R
shift ( B P )	P B
shift ( N X P )	X P N
shift ( shift ( E E P ) )	P E E
prepend ( append ( reverse ( prepend ( F E T , I Y P ) ) , shift ( E D X F ) ) , prepend ( R K K G , prepend ( W T D , Q B V M ) ) )	Q B V M W T D R K K G T E F P Y I D X F E
copy ( F X Q )	F X Q
prepend ( reverse ( S P B ) , append ( L C G U , append ( H P K , copy ( U Y Q H ) ) ) )	L C G U H P K U Y Q H B P S
shift ( append ( reverse ( Q L O N ) , reverse ( O I J U ) ) )	O L Q U J I O N
prepend ( reverse ( T T Z M ) , C D R T )	C D R T M Z T T
prepend ( reverse ( E Z O B ) , G M L J )	G M L J B O Z E
reverse ( X L R U )	U R L X
reverse ( Q W P F )	F P W Q
shift ( copy ( O P D D ) )	P D D O
reverse ( Z Q D )	D Q Z
shift ( P D Q )	D Q P
reverse ( B J S )	S J B
reverse ( J L Q )	Q L J
shift ( L P G G )	P G G L
reverse ( Z R J )	J R Z
echo ( R V C T )	R V C T T
prepend ( I R K , A D X )	A D X I R K
prepend ( X F M , B T B J )	B T B J X F M
echo ( L J N )	L J N N
reverse ( reverse ( F H O E ) )	F H O E
shift ( D Q P )	Q P D
shift ( S X Z )	X Z S
shift ( H S F Y )	S F Y H
reverse ( M N Z U )	U Z N M
prepend ( Z E S F , append ( I Y L , G S U ) )	I Y L G S U Z E S F
shift ( reverse ( reverse ( Q P L Z ) ) )	P L Z Q
echo ( shift ( copy ( reverse ( echo ( X A Q J ) ) ) ) )	J Q A X J J
prepend ( prepend ( copy ( H H T D ) , I J C T ) , Q D Y K )	Q D Y K I J C T H H T D
shift ( N R W E )	R W E N
copy ( Y M S X )	Y M S X
echo ( C T C D )	C T C D D
echo ( T N S )	T N S S
copy ( R J V )	R J V
shift ( Y I A )	I A Y
echo ( V M G )	V M G G
prepend ( U S Z , append ( P S U , J A J ) )	P S U J A J U S Z
echo ( W O A )	W O A A
prepend ( K U D , V P )	V P K U D
shift ( E A U )	A U E
prepend ( J G I , A F C P )	A F C P J G I
append ( R K X , Q W D )	R K X Q W D
prepend ( W A J P , X X J Q )	X X J Q W A J P
shift ( H G )	G H
append ( shift ( reverse ( N U Q ) ) , copy ( shift ( H P O ) ) )	U N Q P O H
append ( Q M E , T Z K M )	Q M E T Z K M
echo ( H U R )	H U R R
copy ( K W F H )	K W F H
reverse ( B E V J )	J V E B
reverse ( J B B )	B B J
copy ( W C A )	W C A
copy ( P U U V )	P U U V
prepend ( T S H , Y N K )	Y N K T S H
echo ( M W U )	M W U U
shift ( L B K W )	B K W L
copy ( I O M A )	I O M A
reverse ( L G Y M )	M Y G L
shift ( R N K Q )	N K Q R
copy ( K M H )	K M H
echo ( copy ( Q U N ) )	Q U N N
echo ( K A S )	K A S S
reverse ( prepend ( shift ( O L X ) , shift ( copy ( N K K ) ) ) )	O X L N K K
reverse ( append ( O I H , D I T M ) )	M T I D H I O
shift ( prepend ( O B I W , reverse ( copy ( G U L G ) ) ) )	L U G O B I W G
shift ( shift ( H C ) )	H C
append ( B A , S U R )	B A S U R
prepend ( P P , S F W )	S F W P P
shift ( X T W )	T W X
append ( append ( shift ( append ( I I C , J V Z ) ) , O L F ) , shift ( Q I T J ) )	I C J V Z I O L F I T J Q
prepend ( O E , K Q I D )	K Q I D O E
reverse ( O V J )	J V O
reverse ( append ( J I J , Y I F X ) )	X F I Y J I J
copy ( Z X U )	Z X U
copy ( M N E R )	M N E R
shift ( B Y L Q )	Y L Q B
prepend ( Y W I , M U J K )	M U J K Y W I
copy ( copy ( F H O M ) )	F H O M
copy ( copy ( M Y V ) )	M Y V
reverse ( shift ( Q U C F ) )	Q F C U
prepend ( J R V Q , echo ( D M Z H ) )	D M Z H H J R V Q
shift ( M I )	I M
reverse ( append ( X Y , Q L B I ) )	I B L Q Y X
reverse ( F T F )	F T F
reverse ( shift ( shift ( M M T ) ) )	M M T
append ( C E , J G H F )	C E J G H F
reverse ( Q D P S )	S P D Q
echo ( L Z A R )	L Z A R R
copy ( S Z Q T )	S Z Q T
echo ( G E P )	G E P P
reverse ( T F M )	M F T
copy ( L M )	L M
shift ( append ( V H , A F U V ) )	H A F U V V
prepend ( Q V Z , copy ( U B O A ) )	U B O A Q V Z
prepend ( copy ( copy ( X Y Y B ) ) , E J I )	E J I X Y Y B
reverse ( C S G )	G S C
prepend ( U R A , R T A )	R T A U R A
copy ( Y H T )	Y H T
shift ( P P I )	P I P
shift ( K M )	M K
echo ( S E S )	S E S S
shift ( T M V )	M V T
reverse ( E J )	J E
reverse ( E T D L )	L D T E
shift ( E M D )	M D E
reverse ( Z L C )	C L Z
reverse ( prepend ( I J I , U C P ) )	I J I P C U
copy ( F X I D )	F X I D
prepend ( copy ( Q N J O ) , J I N X )	J I N X Q N J O
reverse ( echo ( X D S ) )	S S D X
shift ( H P )	P H
copy ( N J V )	N J V
copy ( Z J M )	Z J M
echo ( reverse ( F X E I ) )	I E X F F
copy ( Y N V )	Y N V
prepend ( O A J , copy ( M W L M ) )	M W L M O A J
echo ( K G E P )	K G E P P
prepend ( L N M N , J P M )	J P M L N M N
copy ( Z L I )	Z L I
echo ( prepend ( B Y F , G C Y ) )	G C Y B Y F F
shift ( H T V J )	T V J H
shift ( copy ( copy ( X B V ) ) )	B V X
reverse ( K U B A )	A B U K
reverse ( F C B )	B C F
prepend ( X Q U S , echo ( shift ( copy ( A K ) ) ) )	K A A X Q U S
prepend ( L A Q N , R I G )	R I G L A Q N
shift ( N T K F )	T K F N
reverse ( G I B I )	I B I G
echo ( S O U )	S O U U
reverse ( O X F T )	T F X O
shift ( Y I Y D )	I Y D Y
append ( C D , E S G C )	C D E S G C
echo ( Y G K )	Y G K K
echo ( append ( prepend ( D O N Y , prepend ( I X A , L U ) ) , N T V S ) )	L U I X A D O N Y N T V S S
append ( M Z C U , O G )	M Z C U O G
shift ( F O )	O F
reverse ( B M J Y )	Y J M B
append ( F L Q A , E S E E )	F L Q A E S E E
shift ( U Y Q )	Y Q U
copy ( W Y U R )	W Y U R
prepend ( echo ( copy ( B W H ) ) , D T A K )	D T A K B W H H
prepend ( I B E X , R X )	R X I B E X
append ( append ( P Y V , E K ) , R U D F )	P Y V E K R U D F
copy ( shift ( E D O Z ) )	D O Z E
copy ( S V E )	S V E
echo ( A R H I )	A R H I I
append ( copy ( J S ) , shift ( Y G I ) )	J S G I Y
reverse ( R U )	U R
append ( N G , O K I P )	N G O K I P
reverse ( D A )	A D
copy ( D H X V )	D H X V
echo ( N Z M )	N Z M M
append ( Z T S , S B E Q )	Z T S S B E Q
shift ( reverse ( M O M C ) )	M O M C
copy ( P Q T W )	P Q T W
copy ( shift ( reverse ( A V S ) ) )	V A S
echo ( E W Q T )	E W Q T T
shift ( shift ( prepend ( X I Q , L N D ) ) )	D X I Q L N
append ( E Z T T , copy ( copy ( Y Y W ) ) )	E Z T T Y Y W
echo ( T R Z P )	T R Z P P
shift ( K L H )	L H K
shift ( shift ( U U B ) )	B U U
copy ( D R K )	D R K
append ( S L Y , X M G )	S L Y X M G
prepend ( echo ( R O U ) , echo ( Q L N ) )	Q L N N R O U U
shift ( L O A M )	O A M L
echo ( V Z W F )	V Z W F F
shift ( P A R S )	A R S P
reverse ( append ( append ( T D L , Q T N ) , shift ( W G G C ) ) )	W C G G N T Q L D T
prepend ( P X M I , reverse ( echo ( shift ( prepend ( I E C L , Y A X ) ) ) ) )	Y Y L C E I X A P X M I
copy ( copy ( X K R ) )	X K R
shift ( T S K )	S K T
reverse ( Z L P )	P L Z
reverse ( echo ( T K P ) )	P P K T
copy ( shift ( Y Y V Z ) )	Y V Z Y
copy ( N Y G )	N Y G
echo ( shift ( E K G O ) )	K G O E E
append ( prepend ( V E J W , G G M F ) , copy ( echo ( J D ) ) )	G G M F V E J W J D D
append ( reverse ( V T V ) , Q P G )	V T V Q P G
shift ( K Z P V )	Z P V K
echo ( R A K C )	R A K C C
reverse ( A U N )	N U A
reverse ( V M G U )	U G M V
prepend ( W L P K , N I C W )	N I C W W L P K
copy ( N Q F G )	N Q F G
echo ( shift ( K F D Z ) )	F D Z K K
shift ( Y Z U )	Z U Y
reverse ( F C S R )	R S C F
shift ( W R A L )	R A L W
shift ( D Z Y )	Z Y D
prepend ( J U B , S D X M )	S D X M J U B
copy ( X T S )	X T S
echo ( prepend ( J Z W E , B F W I ) )	B F W I J Z W E E
append ( echo ( I X S Q ) , F O Z )	I X S Q Q F O Z
reverse ( X Z U )	U Z X
shift ( prepend ( P P C J , append ( reverse ( reverse ( F J Y S ) ) , B W T F ) ) )	J Y S B W T F P P C J F
echo ( X Z W M )	X Z W M M
append ( P M G , echo ( R V K ) )	P M G R V K K
reverse ( append ( echo ( prepend ( Z V R , V Y X E ) ) , echo ( W W I ) ) )	I I W W R R V Z E X Y V
shift ( reverse ( S M U A ) )	U M S A
copy ( S M N S )	S M N S
reverse ( Z X R )	R X Z
copy ( W E B )	W E B
reverse ( Y U A )	A U Y
echo ( W F Q W )	W F Q W W
shift ( echo ( M V O ) )	V O O M
echo ( D X J U )	D X J U U
shift ( copy ( C K A T ) )	K A T C
shift ( D E D )	E D D
echo ( prepend ( echo ( A S L ) , append ( N C F , reverse ( echo ( copy ( I N ) ) ) ) ) )	N C F N N I A S L L L
echo ( S H H X )	S H H X X
reverse ( J E C )	C E J
shift ( G M Q D )	M Q D G
prepend ( N Z X Y , F V R N )	F V R N N Z X Y
reverse ( L U D Q )	Q D U L
shift ( prepend ( O V X , N D U ) )	D U O V X N
echo ( K J O )	K J O O
echo ( A L W )	A L W W
append ( X B W , L E )	X B W L E
prepend ( E R W G , shift ( echo ( C G N Y ) ) )	G N Y Y C E R W G
copy ( S M A )	S M A
reverse ( I D D W )	W D D I
prepend ( P W K G , O F C Y )	O F C Y P W K G
prepend ( shift ( P O J S ) , R X K )	R X K O J S P
reverse ( H N N )	N N H
shift ( W D B R )	D B R W
shift ( S A P )	A P S
echo ( copy ( M V H A ) )	M V H A A
append ( D W I U , Z A )	D W I U Z A
copy ( N E S F )	N E S F
prepend ( K R U , Y Z W )	Y Z W K R U
reverse ( A K I )	I K A
prepend ( H X C V , E K L G )	E K L G H X C V
copy ( copy ( append ( shift ( W E P K ) , E G P ) ) )	E P K W E G P
append ( W B V , V O )	W B V V O
prepend ( prepend ( reverse ( C L U ) , H D I Y ) , I J T Q )	I J T Q H D I Y U L C
shift ( R G M )	G M R
reverse ( append ( U O N L , append ( W P W M , O K Z ) ) )	Z K O M W P W L N O U
copy ( V V W R )	V V W R
shift ( shift ( R Q M ) )	M R Q
prepend ( V U J , W H P U )	W H P U V U J
echo ( K W K )	K W K K
copy ( Q R )	Q R
copy ( echo ( echo ( G Q W ) ) )	G Q W W W
prepend ( U B T V , L P A )	L P A U B T V
shift ( echo ( R T Z ) )	T Z Z R
echo ( copy ( reverse ( Y Z J ) ) )	J Z Y Y
shift ( X X R )	X R X
shift ( echo ( C Z ) )	Z Z C
append ( R B , P I C )	R B P I C
echo ( B C T )	B C T T
echo ( Y X K Y )	Y X K Y Y
append ( X D , K Z S )	X D K Z S
reverse ( append ( R Z G M , P F Q ) )	Q F P M G Z R
prepend ( reverse ( P E M ) , C T R )	C T R M E P
copy ( G N K Q )	G N K Q
echo ( F I O D )	F I O D D
shift ( shift ( B C C ) )	C B C
append ( F B M D , shift ( J U E ) )	F B M D U E J
reverse ( Q L C )	C L Q
copy ( O U H )	O U H
prepend ( copy ( R X C L ) , M F Q J )	M F Q J R X C L
reverse ( B X M )	M X B
copy ( M O I A )	M O I A
reverse ( Q Y )	Y Q
shift ( T L )	L T
prepend ( C R W , U R )	U R C R W
echo ( N K N J )	N K N J J
reverse ( copy ( copy ( O V K ) ) )	K V O
echo ( Y J D )	Y J D D
copy ( shift ( D F I ) )	F I D
echo ( R S )	R S S
append ( O H D N , C Y )	O H D N C Y
reverse ( Y S O )	O S Y
prepend ( C G F , append ( E X A , J U M ) )	E X A J U M C G F
prepend ( A C X , J H J )	J H J A C X
copy ( echo ( shift ( prepend ( R V H O , reverse ( O N ) ) ) ) )	O R V H O N N
reverse ( N E F M )	M F E N
copy ( U S E )	U S E
copy ( A Y G )	A Y G
shift ( S W )	W S
copy ( append ( Z I A Q , G H W Y ) )	Z I A Q G H W Y
copy ( append ( O T O , append ( G K F , G H R ) ) )	O T O G K F G H R
prepend ( E M O I , U Q D )	U Q D E M O I
echo ( E L M X )	E L M X X
shift ( W S K )	S K W
reverse ( reverse ( copy ( J V K ) ) )	J V K
copy ( echo ( G K ) )	G K K
prepend ( echo ( W H T L ) , reverse ( J T T ) )	T T J W H T L L
prepend ( copy ( M E V L ) , I Z V )	I Z V M E V L
prepend ( append ( O K N , append ( prepend ( B Y M R , A W ) , append ( X J , E B A V ) ) ) , D U )	D U O K N A W B Y M R X J E B A V
shift ( H I F S )	I F S H
shift ( X J C )	J C X
append ( Y D E C , C H J )	Y D E C C H J
reverse ( R X L )	L X R
append ( Z A M K , C W F O )	Z A M K C W F O
reverse ( I T )	T I
copy ( echo ( G A T ) )	G A T T
append ( R O , D V S )	R O D V S
reverse ( S H V )	V H S
reverse ( copy ( D A M ) )	M A D
echo ( B H N )	B H N N
echo ( Q D P N )	Q D P N N
append ( T U , reverse ( K M Z C ) )	T U C Z M K
prepend ( I Z G , append ( Q G S , reverse ( shift ( E N J ) ) ) )	Q G S E J N I Z G
copy ( J J W M )	J J W M
echo ( Z I O )	Z I O O
echo ( V I S Y )	V I S Y Y
reverse ( L S H R )	R H S L
reverse ( S S E Y )	Y E S S
prepend ( W M L , D C W )	D C W W M L
reverse ( U X D )	D X U
echo ( L U J M )	L U J M M
copy ( R F Y G )	R F Y G
reverse ( copy ( V N X ) )	X N V
echo ( E M B D )	E M B D D
shift ( O P N Q )	P N Q O
copy ( I S N )	I S N
shift ( C Z C P )	Z C P C
echo ( M N S R )	M N S R R
shift ( X P Q )	P Q X
shift ( P K E U )	K E U P
copy ( J Y O K )	J Y O K
prepend ( Y W S U , I F R X )	I F R X Y W S U
reverse ( M J N )	N J M
prepend ( C K Y E , K J L W )	K J L W C K Y E
shift ( P P V J )	P V J P
echo ( X D X Y )	X D X Y Y
shift ( shift ( F L G L ) )	G L F L
copy ( Q S X )	Q S X
copy ( C H F M )	C H F M
copy ( E V J )	E V J
reverse ( O K G )	G K O
shift ( U S J X )	S J X U
reverse ( W J Z Y )	Y Z J W
shift ( W E Q )	E Q W
prepend ( K M I R , shift ( copy ( Z X I T ) ) )	X I T Z K M I R
shift ( U O )	O U
shift ( echo ( P I G ) )	I G G P
append ( H N D , D M G Q )	H N D D M G Q
copy ( copy ( V A R N ) )	V A R N
append ( N T D A , N O A D )	N T D A N O A D
prepend ( shift ( shift ( U W X ) ) , X B L )	X B L X U W
append ( H E H , U V F )	H E H U V F
shift ( I D P )	D P I
reverse ( F H D F )	F D H F
shift ( G X Z R )	X Z R G
copy ( Z Y D )	Z Y D
echo ( shift ( O B G ) )	B G O O
append ( shift ( G N X ) , U Y W L )	N X G U Y W L
prepend ( echo ( M I A ) , A G V R )	A G V R M I A A
echo ( D W W A )	D W W A A
copy ( P F M )	P F M
shift ( I C W R )	C W R I
reverse ( K C V W )	W V C K
append ( W I M U , A P P )	W I M U A P P
echo ( L X W )	L X W W
echo ( P I )	P I I
copy ( D O X )	D O X
shift ( A C )	C A
shift ( reverse ( copy ( prepend ( O Z O , Q A R ) ) ) )	Z O R A Q O
shift ( K X M B )	X M B K
append ( reverse ( C N ) , echo ( Y P H H ) )	N C Y P H H H
append ( reverse ( D M ) , reverse ( M V ) )	M D V M
append ( B E S T , N D G V )	B E S T N D G V
echo ( D R X R )	D R X R R
append ( H N F , L C F )	H N F L C F
echo ( Z L )	Z L L
prepend ( D G B , E O )	E O D G B
reverse ( reverse ( echo ( reverse ( copy ( F C N ) ) ) ) )	N C F F
prepend ( M M B I , X G C I )	X G C I M M B I
echo ( B D N )	B D N N
append ( Z R M K , K P )	Z R M K K P
append ( M Y U , shift ( copy ( G Y R N ) ) )	M Y U Y R N G
prepend ( H C E , W K N )	W K N H C E
copy ( V H A )	V H A
copy ( shift ( E M F H ) )	M F H E
copy ( E U Q )	E U Q
shift ( G V T )	V T G
shift ( echo ( copy ( J N T ) ) )	N T T J
shift ( V T Z E )	T Z E V
append ( I E P P , shift ( Y R ) )	I E P P R Y
append ( E B K Q , S X M N )	E B K Q S X M N
prepend ( O G Q , J Y L N )	J Y L N O G Q
copy ( G F Q )	G F Q
echo ( reverse ( reverse ( N S L V ) ) )	N S L V V
reverse ( Y X )	X Y
copy ( H N B )	H N B
reverse ( H H )	H H
append ( shift ( echo ( W G Q ) ) , H D B M )	G Q Q W H D B M
prepend ( W V , copy ( I W I ) )	I W I W V
reverse ( D K P )	P K D
shift ( reverse ( shift ( J H A ) ) )	A H J
echo ( U E I Z )	U E I Z Z
copy ( P T U )	P T U
shift ( R O L S )	O L S R
shift ( L S C T )	S C T L
shift ( B I X )	I X B
echo ( prepend ( J G F L , W Q P ) )	W Q P J G F L L
reverse ( L R L )	L R L
reverse ( G K H D )	D H K G
shift ( Y B V )	B V Y
reverse ( H O V )	V O H
echo ( G K Y F )	G K Y F F
shift ( W L A V )	L A V W
echo ( J J Z P )	J J Z P P
echo ( G A S Y )	G A S Y Y
echo ( B O )	B O O
append ( D U R , reverse ( J R N ) )	D U R N R J
reverse ( O A D )	D A O
prepend ( append ( V S R L , A T X J ) , echo ( echo ( S W F ) ) )	S W F F F V S R L A T X J
append ( X F V Q , H O X B )	X F V Q H O X B
echo ( Q N I )	Q N I I
reverse ( W T J J )	J J T W
echo ( L G U )	L G U U
echo ( C H K )	C H K K
reverse ( P P I W )	W I P P
copy ( shift ( P K O A ) )	K O A P
reverse ( K V V )	V V K
shift ( G Y Z V )	Y Z V G
echo ( I E M G )	I E M G G
shift ( E I U E )	I U E E
echo ( copy ( S U I ) )	S U I I
prepend ( Q T W L , X R J Y )	X R J Y Q T W L
shift ( append ( W A C , H T ) )	A C H T W
prepend ( echo ( U M L I ) , N Z O )	N Z O U M L I I
echo ( M I J )	M I J J
copy ( Q B I )	Q B I
copy ( Y Q Y E )	Y Q Y E
reverse ( V Y Z )	Z Y V
append ( shift ( copy ( L B M I ) ) , B T X R )	B M I L B T X R
copy ( O B O )	O B O
echo ( C J F H )	C J F H H
prepend ( reverse ( G Y U ) , shift ( N M X E ) )	M X E N U Y G
reverse ( N I Q H )	H Q I N
shift ( S G F P )	G F P S
copy ( echo ( copy ( prepend ( reverse ( L F O S ) , shift ( S V E H ) ) ) ) )	V E H S S O F L L
shift ( R Q U )	Q U R
shift ( H G P )	G P H
reverse ( H T T )	T T H
append ( append ( C L G , B G X ) , E N Q )	C L G B G X E N Q
copy ( V F H M )	V F H M
reverse ( N U V G )	G V U N
shift ( shift ( T F B W ) )	B W T F
reverse ( H I P L )	L P I H
append ( K W B , L S A S )	K W B L S A S
echo ( shift ( V L J ) )	L J V V
copy ( D X K S )	D X K S
copy ( J W A O )	J W A O
echo ( E W J )	E W J J
shift ( W E D )	E D W
shift ( reverse ( V N R V ) )	R N V V
echo ( echo ( U F E H ) )	U F E H H H
echo ( F G )	F G G
shift ( P V C )	V C P
echo ( H L Z W )	H L Z W W
prepend ( O D L , H W E )	H W E O D L
append ( G R D E , S M P G )	G R D E S M P G
copy ( M L )	M L
reverse ( N Y G E )	E G Y N
prepend ( prepend ( V D G , R O C ) , X U )	X U R O C V D G
append ( E K H W , Z S R )	E K H W Z S R
echo ( S V K L )	S V K L L
echo ( append ( M T Z , A P U ) )	M T Z A P U U
shift ( C Y V )	Y V C
append ( C Z P , U G U )	C Z P U G U
copy ( I K G M )	I K G M
shift ( append ( K K O C , O L I K ) )	K O C O L I K K
copy ( reverse ( L F J T ) )	T J F L
copy ( append ( Y B I , I K X M ) )	Y B I I K X M
echo ( append ( P T L Q , T L L E ) )	P T L Q T L L E E
shift ( shift ( R O Y ) )	Y R O
reverse ( V S L Z )	Z L S V
shift ( shift ( M W D ) )	D M W
append ( Q I N , R F B )	Q I N R F B
reverse ( S Y U L )	L U Y S
reverse ( P I Q T )	T Q I P
append ( U B F , N M )	U B F N M
append ( M N R , V J P )	M N R V J P
prepend ( append ( S N T B , D U T U ) , B A V )	B A V S N T B D U T U
append ( E S D P , B P T Y )	E S D P B P T Y
copy ( M P F )	M P F
shift ( G T U P )	T U P G
shift ( U O H H )	O H H U
echo ( Q V T N )	Q V T N N
prepend ( Y C R , O Q A E )	O Q A E Y C R
shift ( reverse ( J G Z D ) )	Z G J D
append ( G V , O Z O B )	G V O Z O B
reverse ( A E F I )	I F E A
append ( N I U D , D J H )	N I U D D J H
copy ( W U L W )	W U L W
echo ( shift ( W U ) )	U W W
echo ( W M K X )	W M K X X
echo ( Y N A S )	Y N A S S
reverse ( Z Q N )	N Q Z
append ( S M H , V S )	S M H V S
echo ( I F I )	I F I I
copy ( copy ( O D ) )	O D
prepend ( U C K , shift ( T S I C ) )	S I C T U C K
copy ( E P S E )	E P S E
reverse ( Y X O )	O X Y
reverse ( F S H )	H S F
shift ( R V I R )	V I R R
copy ( Z F X )	Z F X
copy ( echo ( echo ( W E M Y ) ) )	W E M Y Y Y
shift ( X Z V B )	Z V B X
reverse ( echo ( P S J ) )	J J S P
shift ( copy ( X F K F ) )	F K F X
copy ( D J J L )	D J J L
append ( C H A , shift ( B K L ) )	C H A K L B
copy ( C O Z R )	C O Z R
append ( I J M , Z V T M )	I J M Z V T M
copy ( O H E )	O H E
shift ( X X A Y )	X A Y X
echo ( copy ( Q H A Q ) )	Q H A Q Q
echo ( M K R M )	M K R M M
append ( echo ( K A L ) , Y Z )	K A L L Y Z
reverse ( B Q V )	V Q B
echo ( B Y J B )	B Y J B B
reverse ( R K V )	V K R
copy ( B D M X )	B D M X
copy ( T Y A S )	T Y A S
copy ( J T X S )	J T X S
reverse ( X I N Z )	Z N I X
echo ( G Q O W )	G Q O W W
copy ( reverse ( U G V M ) )	M V G U
prepend ( V A , shift ( B K A V ) )	K A V B V A
reverse ( I M L )	L M I
echo ( N N W )	N N W W
prepend ( Q M G I , Y V A H )	Y V A H Q M G I
prepend ( D V V O , I G C )	I G C D V V O
echo ( append ( V Z P S , U J E G ) )	V Z P S U J E G G
reverse ( D Y N I )	I N Y D
shift ( prepend ( F Q , N H Q K ) )	H Q K F Q N
append ( E A K , S R X )	E A K S R X
reverse ( Q X M )	M X Q
reverse ( shift ( B P D K ) )	B K D P
prepend ( V R K Y , U C U F )	U C U F V R K Y
copy ( prepend ( reverse ( M D P H ) , L B ) )	L B H P D M
copy ( append ( K R T , T H H ) )	K R T T H H
copy ( echo ( U R R D ) )	U R R D D
shift ( C R B T )	R B T C
shift ( echo ( L B Y ) )	B Y Y L
prepend ( shift ( J C R ) , echo ( W V A H ) )	W V A H H C R J
copy ( E J Z J )	E J Z J
copy ( H Q R )	H Q R
echo ( L H B O )	L H B O O
shift ( Q T B F )	T B F Q
prepend ( shift ( echo ( Q W N D ) ) , K M X )	K M X W N D D Q
prepend ( prepend ( K K L , E R Q ) , D F )	D F E R Q K K L
echo ( G O J )	G O J J
reverse ( shift ( G E F ) )	G F E
reverse ( X B N )	N B X
shift ( W I Q )	I Q W
copy ( V F C N )	V F C N
append ( shift ( M N P ) , R U Y )	N P M R U Y
shift ( copy ( F V V ) )	V V F
shift ( H H Z W )	H Z W H
copy ( R N T )	R N T
prepend ( Q S , X X Q R )	X X Q R Q S
reverse ( Q U Q )	Q U Q
echo ( U D L )	U D L L
reverse ( Y M S Y )	Y S M Y
reverse ( prepend ( N W Y R , append ( append ( G D M I , U L G ) , M Y H ) ) )	R Y W N H Y M G L U I M D G
echo ( S J A V )	S J A V V
echo ( M Z A )	M Z A A
reverse ( F E X )	X E F
reverse ( prepend ( X T C K , X E Q B ) )	K C T X B Q E X
reverse ( G M O )	O M G
copy ( Z K C D )	Z K C D
append ( append ( copy ( shift ( copy ( H J P ) ) ) , reverse ( echo ( G G M ) ) ) , H A )	J P H M M G G H A
prepend ( copy ( P Y O A ) , copy ( echo ( F C U O ) ) )	F C U O O P Y O A
shift ( T T M )	T M T
copy ( shift ( G X T L ) )	X T L G
copy ( Y Z D W )	Y Z D W
echo ( copy ( Q Y M Y ) )	Q Y M Y Y
prepend ( J H R P , R R W D )	R R W D J H R P
reverse ( Q B Y )	Y B Q
prepend ( reverse ( J U R ) , S N U )	S N U R U J
echo ( T L N X )	T L N X X
prepend ( S H C P , shift ( O C ) )	C O S H C P
reverse ( I E D )	D E I
shift ( M D B A )	D B A M
echo ( S D D )	S D D D
copy ( C L D R )	C L D R
shift ( append ( echo ( O L O P ) , F Y G ) )	L O P P F Y G O
append ( A W A , Z B J )	A W A Z B J
shift ( B C F )	C F B
shift ( C Z N M )	Z N M C
shift ( Z B )	B Z
reverse ( V R D A )	A D R V
copy ( H Z S N )	H Z S N
reverse ( G S P )	P S G
echo ( Q K O A )	Q K O A A
copy ( H I V )	H I V
echo ( shift ( reverse ( O E K V ) ) )	K E O V V
prepend ( U Z D A , N I E M )	N I E M U Z D A
reverse ( N X R V )	V R X N
copy ( Z S X )	Z S X
shift ( C N F )	N F C
reverse ( O K P )	P K O
reverse ( N J R )	R J N
append ( Y L , Y K R S )	Y L Y K R S
prepend ( shift ( N J J ) , D S Q Y )	D S Q Y J J N
shift ( O V T )	V T O
shift ( prepend ( J R B R , E M N O ) )	M N O J R B R E
echo ( H X C )	H X C C
echo ( O K U )	O K U U
copy ( reverse ( reverse ( Q Q R ) ) )	Q Q R
shift ( shift ( U M S ) )	S U M
reverse ( reverse ( C J P ) )	C J P
shift ( S T N V )	T N V S
reverse ( B O J )	J O B
shift ( V Y W )	Y W V
echo ( reverse ( O A M E ) )	E M A O O
shift ( reverse ( append ( H B X I , G P R E ) ) )	R P G I X B H E
reverse ( shift ( B N C ) )	B C N
copy ( prepend ( Z W I , R F K Z ) )	R F K Z Z W I
shift ( D F R O )	F R O D
echo ( T K D )	T K D D
copy ( H H Q )	H H Q
copy ( R L Z N )	R L Z N
shift ( echo ( W N T P ) )	N T P P W
append ( append ( J Q D X , J V W K ) , D N R )	J Q D X J V W K D N R
prepend ( L V G C , U P N )	U P N L V G C
prepend ( M R D D , J X E )	J X E M R D D
shift ( A R Z Z )	R Z Z A
reverse ( C P O S )	S O P C
shift ( W I X M )	I X M W
echo ( J G C M )	J G C M M
echo ( U B C O )	U B C O O
copy ( append ( U N H P , T V E F ) )	U N H P T V E F
echo ( E B S E )	E B S E E
shift ( X L J )	L J X
echo ( N G D )	N G D D
echo ( G H S )	G H S S
reverse ( R N C X )	X C N R
reverse ( N P )	P N
append ( L Z , copy ( X M Z G ) )	L Z X M Z G
prepend ( copy ( F Q D ) , shift ( append ( prepend ( C K X I , shift ( Y G P ) ) , E N R N ) ) )	P Y C K X I E N R N G F Q D
echo ( M J S F )	M J S F F
copy ( E R Z M )	E R Z M
copy ( Z V M )	Z V M
shift ( E A V )	A V E
reverse ( T K N )	N K T
reverse ( append ( Y T S , A L T N ) )	N T L A S T Y
shift ( shift ( shift ( W S Z ) ) )	W S Z
shift ( prepend ( G Q A Z , Z C C Z ) )	C C Z G Q A Z Z
echo ( F U D K )	F U D K K
shift ( Z W W )	W W Z
copy ( reverse ( R M ) )	M R
shift ( C R K K )	R K K C
reverse ( F H I T )	T I H F
shift ( R U N )	U N R
shift ( Y G X O )	G X O Y
copy ( K I S )	K I S
reverse ( M T L T )	T L T M
shift ( X R W )	R W X
shift ( B K U S )	K U S B
echo ( M J X )	M J X X
shift ( G L S )	L S G
shift ( echo ( copy ( echo ( shift ( prepend ( B L X , H F J ) ) ) ) ) )	J B L X H H H F
prepend ( V Q S , R Y E A )	R Y E A V Q S
reverse ( Y O F )	F O Y
copy ( U E N I )	U E N I
append ( E J R , Y U )	E J R Y U
copy ( I E P )	I E P
reverse ( E U L X )	X L U E
echo ( echo ( W C T Y ) )	W C T Y Y Y
echo ( copy ( C Z G E ) )	C Z G E E
shift ( K J D D )	J D D K
append ( X X F , R O D )	X X F R O D
append ( Y J , M J H )	Y J M J H
shift ( prepend ( X E P , reverse ( reverse ( L U I H ) ) ) )	U I H X E P L
copy ( shift ( O W T ) )	W T O
append ( L J E D , shift ( T M T ) )	L J E D M T T
echo ( I A )	I A A
copy ( O F U L )	O F U L
reverse ( B M C )	C M B
echo ( H V Q E )	H V Q E E
append ( shift ( Y K ) , shift ( H C B ) )	K Y C B H
append ( Y V R , F A Z )	Y V R F A Z
prepend ( shift ( P R L F ) , echo ( U Z R T ) )	U Z R T T R L F P
echo ( P Z L I )	P Z L I I
reverse ( N Q C C )	C C Q N
shift ( D I C )	I C D
copy ( R M L )	R M L
copy ( R S D )	R S D
prepend ( X I R , T T A U )	T T A U X I R
reverse ( I T X )	X T I
append ( B Y P , echo ( Q J V ) )	B Y P Q J V V
reverse ( X A D E )	E D A X
reverse ( copy ( U I S E ) )	E S I U
copy ( Y E Y )	Y E Y
copy ( copy ( G J D U ) )	G J D U
echo ( A Q O V )	A Q O V V
reverse ( echo ( N L L I ) )	I I L L N
shift ( F S S )	S S F
echo ( append ( B G U L , Y I L L ) )	B G U L Y I L L L
copy ( append ( X A A L , M L D D ) )	X A A L M L D D
reverse ( V Y Z L )	L Z Y V
append ( L E Y , G I )	L E Y G I
copy ( E W Z )	E W Z
prepend ( D R H , T H Q )	T H Q D R H
echo ( D T F T )	D T F T T
append ( J W I J , Z O E Z )	J W I J Z O E Z
echo ( H P D )	H P D D
copy ( G C N )	G C N
echo ( L L A )	L L A A
copy ( F W R R )	F W R R
reverse ( X H S N )	N S H X
copy ( F J H )	F J H
reverse ( A H Y A )	A Y H A
append ( W Q E X , G F D )	W Q E X G F D
copy ( I U T )	I U T
prepend ( J L T , G X U I )	G X U I J L T
reverse ( S R O )	O R S
echo ( D H S )	D H S S
echo ( reverse ( reverse ( N E E N ) ) )	N E E N N
copy ( F H F T )	F H F T
shift ( W R M Y )	R M Y W
copy ( M O D B )	M O D B
copy ( C V V )	C V V
append ( Z Z R W , echo ( shift ( N F S E ) ) )	Z Z R W F S E N N
reverse ( prepend ( U W F D , T H S F ) )	D F W U F S H T
prepend ( prepend ( reverse ( D E X J ) , echo ( L H F I ) ) , L F )	L F L H F I I J X E D
copy ( P Y B L )	P Y B L
prepend ( D X V , P K S )	P K S D X V
copy ( B T Y )	B T Y
prepend ( N U Z J , T A )	T A N U Z J
copy ( Q W I )	Q W I
copy ( O W E )	O W E
prepend ( F O W T , Z M I N )	Z M I N F O W T
echo ( echo ( H L ) )	H L L L
echo ( echo ( shift ( F P S W ) ) )	P S W F F F
copy ( copy ( J H A U ) )	J H A U
echo ( V I T B )	V I T B B
copy ( B L )	B L
append ( shift ( S C K ) , V S T )	C K S V S T
echo ( P H C G )	P H C G G
copy ( J R Q )	J R Q
prepend ( echo ( prepend ( A C E , I K Y J ) ) , E A K X )	E A K X I K Y J A C E E
echo ( copy ( E O E ) )	E O E E
copy ( E Z I A )	E Z I A
copy ( Q T J L )	Q T J L
append ( P E T , Y A W )	P E T Y A W
echo ( P U S C )	P U S C C
prepend ( H O , M X Z )	M X Z H O
copy ( Z H K )	Z H K
prepend ( shift ( append ( B V D , Y Z I O ) ) , append ( J R L , N K L O ) )	J R L N K L O V D Y Z I O B
shift ( copy ( T Y F F ) )	Y F F T
reverse ( append ( Q K X D , V Z S P ) )	P S Z V D X K Q
copy ( Y Q G )	Y Q G
shift ( S V O X )	V O X S
copy ( U R X A )	U R X A
append ( D Y G U , echo ( L P O U ) )	D Y G U L P O U U
reverse ( R R Z S )	S Z R R
shift ( V H G )	H G V
